XXX X   X 
     XX X 
X    XXX X
     XX X 
X    XXX X
     XX X 
X     XXX 
X X X     
XX X X    
X   XX   X