XXXX  XX  XXXXX XXXX
XX     X         XXX
XX    X     X    XXX
X    X     XX     XX
X          XXXXXXXXX
XXX XX
XX             XXX
XX           XX
XX          X
X           X      X
X      X   XXX   XXX
XXXXXX X   XXXX XXXX
