XXX             XXXX
 X      XX         X
  X      X          
   X                
    X               
     XXXXXXXXX      
                    
X                   
                   X
      XXXXXX        
XXXXXXX     XXX     