                           
                           
                           
XX  XXXXXXXX  XXXXXXXX  XXX
XXX  XXXXXXX  XXXXXXX  XXXX
XXXX  XXXXXX  XXXXXX  XXXXX
XXXXX  XXXXX  XXXXX  XXXXXX
XXXXXX  XXXX  XXXX  XXXXXXX
XXXXXXX  XXX  XXX  XXXXXXXX
                           
                           
XXXXXXXXXX      XXXXXXXXXXX

XXXXXXXXXXXXXXXXXXXXXXXXXXX